日報表(峻儒)  保單/批單
續保通知明細表HAS517(峻儒)
月出單件數統計表HAS519(峻儒)
續保損率表HAS523(峻儒)
保險大戶保費明細表HAS524(峻儒)
稅捐資料轉出HAS911(峻儒)


IAP	新光產物團體傷害保險(個人件)
IBP	新光產物團體傷害保險
ICP	新光產物微型個人傷害保險
IDP	新光產物交通工具乘員平安團體傷害保險
IEP	新光產物借貸團體傷害保險
IFP	新光產物家庭成員責任與住宅動產火災綜合保險
IGP	新光產物團體傷害保險
IHP	僱主意外責任保險附加團體傷害保險
IIP	新光產物個人責任保險附加傷害保險
IJP	新光產物借貸團體傷害暨暫時失能保險
IMP	新光產物傷害保險(個人暨家庭型)
IPP	新光產物個人傷害保險
IQP	新光產物旅行平安保險
IRP	新光產物旅行平安保險暨個人旅行綜合保險
ISP	新光產物平安個人傷害保險
ITP	新光產物個人旅行綜合保險